###################
#Cooooooo#oooooooC#
#o##o###o#o###o##o#
#ooooooooooooooooo#
#o##o#o#####o#o##o#
#oooo#ooo#ooo#oooo#
####o### # ### ####
   #o#   R   #o#
####o# ## ## #o####
#   o  #BPO#      #
####o# ##### #o####
   #o#       #o#
####o# ##### #o####
#oooooooo#oooooooo#
#o##o###o#o###o##o#
#oo#ooooo@ooooo#oo#
##o#o#o#####o#o#o##
#oooo#ooo#ooo#oooo#
#o######o#o######o#
#ooooooooooooooooo#
###################
