###################
#Cooooo#ooo#oooooC#
#o####o#o#o#o####o#
#o#oooooo#oooooo#o#
#ooo#o##o#o##o#ooo#
###o#ooooooooo#o###
#ooo###o###o###ooo#
#o#ooooooRoooooo#o#
#o##o#o##o##o#o##o#
#oooo#o#BPO#o#oooo#
#o#o##o#####o##o#o#
#o#ooooooMoooooo#o#
#o##o###o#o###o##o#
#oooo#ooo#ooo#oooo#
##o#o#o#####o#o#o##
#oo#ooooo@ooooo#oo#
#o##o###o#o###o##o#
#oooo#ooo#ooo#oooo#
#o##o#o#####o#o##o#
#Cooo#ooooooo#oooC#
###################
