############################################################
############################################################
#### @                                                  ####
#### ################################## ############### ####
#### #### ########## ###  O        #### ##              ####
#### ### # ######## # ## ############## ## ############ ####
#### ### ## ###### ## ## ############## ## ############ ####
#### ### ### #### ### ## ############## ## ############ ####
#### ### #### ## #### ##        ####### ## ############ ####
#### ### #####  ##### ## ############## ## ############ ####
#### ### ############ ## ############## ## ############ ####
#### ### ############ ## ############## ## ############ ####
#### ### ############ ##           #### ### B           ####
#### ### ############ ## ############## ############### ####
####                                                    ####
#### ### ############################################## ####
#### ### ###############           ####                 ####
#### ### ############### ############## ## ############ ####
#### ### ############### ############## ## ############ ####
#### ### ############### ############## ## ############ ####
#### ### ###############      R ####### ## ############ ####
#### ### ############### ############## ## ############ ####
#### ### ############### ############## ## ############ ####
#### ### ############### ############## ## ############ ####
#### ###            ####           #### ###             ####
#### ################### ############################## ####
#### ################### ############################## ####
####   P                                                ####
############################################################
############################################################