###################
#Cooo#ooooooo#oooC#
#o##o#o#####o#o##o#
#oo#ooooo#ooooo#oo#
##o#o#o#o#o#o#o#o##
#oooo#o#ooo#o#oooo#
##o#o#o#####o#o#o##
#oo#ooo#####ooo#oo#
#o##oooooRooooo##o#
#oooo#o##o##o#oooo#
####o#o#BPo#o#o####
###oo#o#####o#oo###
#oooo#o#####o#oooo#
#o##o#oooMooo#o##o#
#oo#o#o#####o#o#oo#
##o#o#ooo#ooo#o#o##
#oooooo#o@o#oooooo#
#oooooo#ooo#oooooo#
##o#o###ooo###o#o##
#Co#ooooo#ooooo#oC#
###################