###################
#ooPooooo#ooooooOo#
#o##o###o#o###o##o#
#ooooooooooooooooo#
#o##o#o#####o#o##o#
#oooo#ooo#ooo#oooo#
####o###o#o###o####
   #o#       #o#
####o# ## ## #o####
#   o  #   #  o   #
####o# ##### #o####
   #o#       #o#
####o###o#o###o####
#oooo#ooo#ooo#oooo#
#o##o#o#####o#o##o#
#ooooooooooooooooo#
#o##o###o#@###o##o#
#oooooooo#oooBoooo#
###################